Account Number,Type,Mode,Amount,Current Balance,Transaction Timestamp,Value Date,txnId,Narration,Reference
XXXXXXXX9648,CREDIT,OTHERS,100.05,2060.63,2012-09-05T10:30:00-05:00,2012-09-05,0rtaHkC2d7Umeprl,APBS/IOC Ref No3000044537/9050886278894,REF6268300069992
XXXXXXXX9648,CREDIT,OTHERS,54.05,2114.68,2012-09-05T10:30:00-05:00,2012-09-05,0rtaHkD2e7Umeprl,APBS/IOC Ref No3000025537/9050886296222,REF6268300058892
XXXXXXXX9648,DEBIT,OTHERS,1000.0,1114.68,2012-10-05T10:30:00-05:00,2012-10-05,P3jdhdt0vd6eNJ21,ATM/SACWL094/CASH WDL/03-08-19,REF4310323287606
XXXXXXXX9648,CREDIT,OTHERS,54.05,1168.73,2012-10-05T10:30:00-05:00,2012-10-05,0rtaHkB2c7Umeprl,APBS/IOC Ref No3000023537/9050886296694,REF6268300049792
XXXXXXXX9648,DEBIT,OTHERS,310.0,858.73,2012-11-05T10:30:00-05:00,2012-11-05,okEvrxsOXrild1Gp,VPS/PETRO MALL /201908061708/921811721704/GURG AON,REF0490614055644
XXXXXXXX9648,DEBIT,OTHERS,510.0,348.73,2012-11-05T10:30:00-05:00,2012-11-05,nmX9UV5quJ4EGF2h,VPS/AKASHI FILL/201908062240/921817193607/GU RGAON,REF5343625839778
XXXXXXXX9648,DEBIT,OTHERS,20.0,328.73,2012-12-05T10:30:00-05:00,2012-12-05,8sFMxZ0WekC5lcyT,IPS/DLF CYBERCI/201908081545/000000002691/GURGAON,REF4628032568528
XXXXXXXX9648,DEBIT,OTHERS,310.0,18.73,2012-12-05T10:30:00-05:00,2012-12-05,g3nZydU1q5HxRpRn,IPS/AUTO CARE C/201908081607/000000015852/GUR GAON,REF9409942979705
XXXXXXXX9648,CREDIT,OTHERS,2.32,21.05,2013-01-05T10:30:00-05:00,2013-01-05,bkQH0Z5yM2EV1Fhs,IPS REF DT 09 08 2019 012112 HPCL 0 75 CASHLESS I,REF1289197944993
XXXXXXXX9648,CREDIT,OTHERS,3.83,24.88,2013-01-05T10:30:00-05:00,2013-01-05,mF4TWwBfeuZN78Pn,VISA REF AKASHI FILLING STATION,REF8282842676211
XXXXXXXX9648,CREDIT,OTHERS,5000.0,5024.88,2013-02-05T10:30:00-05:00,2013-02-05,9YJlc6IYTWf3kYkZ,MMT/IMPS/923221428759/MB: MANISH/SONAL SRI/KOTAK,REF8821361127561
XXXXXXXX9648,DEBIT,OTHERS,3573.0,1451.88,2013-02-05T10:30:00-05:00,2013-02-05,Z6L6GYoyvQBxKe4O,ACH/INDUSIND BANK CFD/222681814,REF9136953064910
XXXXXXXX9648,DEBIT,OTHERS,310.0,1141.88,2013-03-05T10:30:00-05:00,2013-03-05,MT3jGbzAlZqP1nfe,VPS/H P KATARIA/201908210947/923304407484/GURGAON,REF8403557902458
XXXXXXXX9648,CREDIT,OTHERS,33000.0,34141.88,2013-03-05T10:30:00-05:00,2013-03-05,COVDqYiyIWQdVUFb,BY CASH - GURGAON - NEW RAILWAY ROAD,REF8657767398362
XXXXXXXX9648,DEBIT,OTHERS,15005.9,19135.98,2013-04-05T10:30:00-05:00,2013-04-05,TnHBKpZ1YHXTzSKk,MMT/IMPS/923317826998/Dolly/Dolly/ PUNB0210500,REF4528413264599
XXXXXXXX9648,DEBIT,OTHERS,5000.0,14135.98,2013-04-05T10:30:00-05:00,2013-04-05,QdxdiUkKgVE9P5E8,NFS/DERO4265/CASH WDL/21-08-19,REF9865097757446
XXXXXXXX9648,DEBIT,OTHERS,2005.9,12130.08,2013-05-05T10:30:00-05:00,2013-05-05,Bw0oWP37qGvJaHnI,MMT/IMPS/923320258618/NA/Ranjeet/ SBIN0006887,REF6795538087935
XXXXXXXX9648,DEBIT,OTHERS,700.0,11430.08,2013-05-05T10:30:00-05:00,2013-05-05,RoNEUc4Cb9acIdyS,IPS/AUTO CARE C/201908241539/000000018223/GUR GAON,REF3532100502490
XXXXXXXX9648,CREDIT,OTHERS,1.0,11431.08,2013-06-05T10:30:00-05:00,2013-06-05,yxmd8YXUGKm2XKXZ,MMT/IMPS/923814568013/154194recy clede/Recycle De t,REF3054356562256
XXXXXXXX9648,CREDIT,OTHERS,2499.0,13930.08,2013-06-05T10:30:00-05:00,2013-06-05,sbpXe18RFuVzebG0,MMT/IMPS/923814568177/154194recy clede/Recycle De t,REF4903472911161
XXXXXXXX9648,DEBIT,OTHERS,505.9,13424.18,2013-07-05T10:30:00-05:00,2013-07-05,V1cFVDlIsLq14pjN,MMT/IMPS/923819230077/Matrial/Ranj eet/SBIN0006887,REF1840790340701
XXXXXXXX9648,DEBIT,OTHERS,2500.0,10924.18,2013-07-05T10:30:00-05:00,2013-07-05,m6I9l162X5Qj0OCC,ATM/SPCNH097/CASH WDL/26-08-19,REF5868465886994
XXXXXXXX9648,CREDIT,OTHERS,2.33,10926.51,2013-08-05T10:30:00-05:00,2013-08-05,yzrEex3tJyJ5S9Aq,VISA REF H P KATARIA FUEL CO,REF7131434751609
XXXXXXXX9648,DEBIT,OTHERS,5000.0,5926.51,2013-08-05T10:30:00-05:00,2013-08-05,L2KswMeUmlHDwmK3,NFS/DECN1081/CASH WDL/27-08-19,REF9071723059853
XXXXXXXX9648,DEBIT,OTHERS,310.0,5616.51,2013-09-05T10:30:00-05:00,2013-09-05,MkUnCFzWXzQl5Su8,VPS/BP 38 /201908281141/924006807583/GURG AON,REF5392766788901
XXXXXXXX9648,CREDIT,OTHERS,5.25,5621.76,2013-09-05T10:30:00-05:00,2013-09-05,YQPK0BZUdok1gR6i,IPS REF DT 25 08 2019 003278 HPCL 0 75 CASHLESS I,REF2214811558961
XXXXXXXX9648,DEBIT,OTHERS,29.5,5592.26,2013-10-05T10:30:00-05:00,2013-10-05,MsHaXqUTRaswCyh0,POSDEC CHG/28-07-2019/1560+GST,REF0977020988797
XXXXXXXX9648,DEBIT,OTHERS,29.5,5562.76,2013-10-05T10:30:00-05:00,2013-10-05,KSTanHbcTDcTiSxn,POSDEC CHG/17-08-2019/1560+GST,REF0850307197542
XXXXXXXX9648,DEBIT,OTHERS,3000.0,2562.76,2013-11-05T10:30:00-05:00,2013-11-05,Vo20yrglBsV1NqwA,NFS/S1ANDE23/CASH WDL/31-08-19,REF8537601727194
XXXXXXXX9648,DEBIT,OTHERS,310.0,2252.76,2013-11-05T10:30:00-05:00,2013-11-05,mDBrEgG68b0vDy41,VPS/JANTA FILLI/201908311520/924309753025/G URGAON,REF4718471868626
XXXXXXXX9648,DEBIT,OTHERS,345.0,1907.76,2013-12-05T10:30:00-05:00,2013-12-05,kiTwh5zkiiKOKMyx,BIL/RCHG/001788909389/Airtel DTH/3018748260,REF7743777419679
XXXXXXXX9648,DEBIT,OTHERS,399.0,1508.76,2013-12-05T10:30:00-05:00,2013-12-05,Ht8TqQACPHMTX8sb,BIL/RCHG/001789051693/Airtel -D/9821315054,REF0979770153770
XXXXXXXX9648,DEBIT,OTHERS,307.68,1201.08,2014-01-05T10:30:00-05:00,2014-01-05,lB814GD3Z2TCyEOU,IPS/NAVYUG FUEL/201909031424/000000000960/G URGAON,REF8665174238294
XXXXXXXX9648,CREDIT,OTHERS,2.33,1203.41,2014-01-05T10:30:00-05:00,2014-01-05,PYbBHBdMP6bvx9mY,VISA REF BP 38,REF6131071611666
XXXXXXXX9648,DEBIT,OTHERS,1000.0,203.41,2014-02-05T10:30:00-05:00,2014-02-05,INqvTkhoBFBDNbBC,NFS/01565122/CASH WDL/04-09-19,REF9205300501166
XXXXXXXX9648,CREDIT,OTHERS,3000.0,3203.41,2014-02-05T10:30:00-05:00,2014-02-05,YwQCzLGur03x4XOl,MMT/IMPS/924716106231/MB: MANISH/SONAL SRI/KOTAK,REF9358827695196
XXXXXXXX9648,DEBIT,OTHERS,2000.0,1203.41,2014-03-05T10:30:00-05:00,2014-03-05,k0RYjF6nDebV8Bfl,NFS/S1ANDE23/CASH WDL/04-09-19,REF4221390435723
XXXXXXXX9648,CREDIT,OTHERS,2.33,1205.74,2014-03-05T10:30:00-05:00,2014-03-05,oNpRRLg4vUaIrad9,VISA REF JANTA FILLING STATION,REF2021848827007
XXXXXXXX9648,DEBIT,OTHERS,310.0,895.74,2014-04-05T10:30:00-05:00,2014-04-05,Zr0RizcCncb8mC69,VPS/KARMVEER FI/201909071910/925013436407/GUR GAON,REF3981727179881
XXXXXXXX9648,CREDIT,OTHERS,15000.0,15895.74,2014-04-05T10:30:00-05:00,2014-04-05,6ZyjFWK5GbKiYfQq,MMT/IMPS/925021629711/MB: MANISH/SONAL SRI/KOTAK,REF7173036781595
XXXXXXXX9648,DEBIT,OTHERS,3536.38,12359.36,2014-05-05T10:30:00-05:00,2014-05-05,K1mPXVXUPhUzKgV2,VIN/ONE97 COMMU/201909072146/925016072957/,REF9608397376687
XXXXXXXX9648,DEBIT,OTHERS,2996.38,9362.98,2014-05-05T10:30:00-05:00,2014-05-05,2kg79BsUW0l8oOhW,IIN/IRCTC E TIC/201909072153/925016906893/,REF0128794494996
XXXXXXXX9648,CREDIT,OTHERS,1.0,9363.98,2014-06-05T10:30:00-05:00,2014-06-05,DjOPtDGqWBWD1MDY,MMT/IMPS/925118844893/YRvAAN184742/BAJAJ FINA/INDU,REF4839660634763
XXXXXXXX9648,DEBIT,OTHERS,5600.0,3763.98,2014-06-05T10:30:00-05:00,2014-06-05,tzG4jXVFzexpikga,VPS/3R COMMUNIC/201909081913/925113198910/GURGAON,REF3215100870547
XXXXXXXX9648,DEBIT,OTHERS,3000.0,763.98,2014-07-05T10:30:00-05:00,2014-07-05,W8cYsvpdJ7Sat6yz,NFS/03190621/CASH WDL/10-09-19,REF6822675265952
XXXXXXXX9648,DEBIT,OTHERS,310.0,453.98,2014-07-05T10:30:00-05:00,2014-07-05,pNLexctzfcHq6TdN,VPS/AKASHI FILL/201909111042/925405745126/GU RGAON,REF3246236738985
XXXXXXXX9648,DEBIT,OTHERS,307.68,146.30,2014-08-05T10:30:00-05:00,2014-08-05,truXeSAebpfbnfp7,IPS/NAVYUG FUEL/201909131835/000000002176/G URGAON,REF7002255933329
XXXXXXXX9648,CREDIT,OTHERS,2.33,148.63,2014-08-05T10:30:00-05:00,2014-08-05,a9FGsdL89dLiC0l5,VISA REF KARMVEER FILLING STATI,REF3219971220711
XXXXXXXX9648,CREDIT,OTHERS,5000.0,5148.63,2014-09-05T10:30:00-05:00,2014-09-05,gYHjiVYxf7BMyfst,MMT/IMPS/925708221423/MB: MANISH/SONAL SRI/KOTAK,REF3611043508511
XXXXXXXX9648,DEBIT,OTHERS,449.0,4699.63,2014-09-05T10:30:00-05:00,2014-09-05,Tf1SZCzV8SdEKJ27,BIL/RCHG/001799633461/Reliance J/8210372800,REF0365838810166
XXXXXXXX9648,DEBIT,OTHERS,2000.0,2699.63,2014-10-05T10:30:00-05:00,2014-10-05,UR4ff0xiNiISfloa,NFS/MN159201/CASH WDL/14-09-19,REF8898626279679
XXXXXXXX9648,DEBIT,OTHERS,29.5,2670.13,2014-10-05T10:30:00-05:00,2014-10-05,VQORXiNjQfbLoQQh,POSDEC CHG/17-08-2019/1560+GST,REF7733933912265
XXXXXXXX9648,DEBIT,OTHERS,2000.0,670.13,2014-11-05T10:30:00-05:00,2014-11-05,2dfg2AwZ3AyQsqKk,ATM/SPCND037/CASH WDL/16-09-19,REF4196763044356
XXXXXXXX9648,DEBIT,OTHERS,370.0,300.13,2014-11-05T10:30:00-05:00,2014-11-05,exVo6HouVRs1hj8j,VPS/BP 38 /201909161623/925910257226/GURG AON,REF2315768578683
XXXXXXXX9648,CREDIT,OTHERS,7.73,307.86,2014-12-05T10:30:00-05:00,2014-12-05,htGtRRWn9OB4BVcE,VISA REF TEX MAX FILLING STATION,REF4903952864687
XXXXXXXX9648,CREDIT,OTHERS,1470.0,1777.86,2014-12-05T10:30:00-05:00,2014-12-05,8U1CnZBFbYmz02y7,IPS REF DT 15 09 2019 011703 IRCTC E TICKETING,REF9857193756194
XXXXXXXX9648,CREDIT,OTHERS,2.33,1780.19,2015-01-05T10:30:00-05:00,2015-01-05,1x9Kh53qOWlPExRd,VISA REF AKASHI FILLING STATION,REF9180841107258
XXXXXXXX9648,CREDIT,OTHERS,6000.0,7780.19,2015-01-05T10:30:00-05:00,2015-01-05,7lPfANmtKczQOtfe,BY CASH-GURGAON - NEW RAILWAY ROAD,REF2997458439356
XXXXXXXX9648,DEBIT,OTHERS,1000.0,6780.19,2015-02-05T10:30:00-05:00,2015-02-05,2CiSF2Alqm9LTDWa,NFS/S1ANDE23/CASH WDL/19-09-19,REF3454157775940
XXXXXXXX9648,CREDIT,OTHERS,3080.0,9860.19,2015-02-05T10:30:00-05:00,2015-02-05,gxmefMEpdyHVla2k,VISA REF IRCTC,REF9266693811391
XXXXXXXX9648,DEBIT,OTHERS,310.0,9550.19,2015-03-05T10:30:00-05:00,2015-03-05,gwpSsO1M4kZJdBSN,VPS/KARMVEER FI/201909191840/926213038659/GUR GAON,REF9610171154995
XXXXXXXX9648,DEBIT,OTHERS,5005.9,4544.29,2015-03-05T10:30:00-05:00,2015-03-05,hxPhFi3pZ8MnSs6J,MMT/IMPS/926220495650/Manu hdfc/HDFC0004233,REF2308590788775
XXXXXXXX9648,DEBIT,OTHERS,100.0,4444.29,2015-04-05T10:30:00-05:00,2015-04-05,i2DP4rB6EHomn47f,BIL/RCHG/001803385864/Airtel -B/7759099310,REF7069993112953
XXXXXXXX9648,CREDIT,OTHERS,2.78,4447.07,2015-04-05T10:30:00-05:00,2015-04-05,soVFkOhOBpmctI8I,VISA REF BP 38,REF5603174735270
XXXXXXXX9648,CREDIT,OTHERS,30000.0,34447.07,2015-05-05T10:30:00-05:00,2015-05-05,jv1d7VTolqjSi2TI,CLG/BRAJ BHUSHAN PRASAD/044908/CBI/18.09.2019,REF0553149962442
XXXXXXXX9648,DEBIT,OTHERS,3573.0,30874.07,2015-05-05T10:30:00-05:00,2015-05-05,npd5EDnh1dnxDST5,ACH/INDUSIND BANK CFD/222681815,REF3519692060661
XXXXXXXX9648,DEBIT,OTHERS,6023.6,24850.47,2015-06-05T10:30:00-05:00,2015-06-05,r32VRbqnxrIq0a3D,NFS/S1ANMA96/CASH WDL/21-09-19/Fee Rs20.00 GST Rs3,REF0443301072740
XXXXXXXX9648,CREDIT,OTHERS,2.33,24852.80,2015-06-05T10:30:00-05:00,2015-06-05,HPDNA3OkmfjG4JT3,VPS REF DISCOUNT ON FUEL PURCHASE,REF5430873026711
XXXXXXXX9648,DEBIT,OTHERS,3798.0,21054.80,2015-07-05T10:30:00-05:00,2015-07-05,CgJHV0fGdMUQbjwA,VIN/PAYTM /201909221524/926509802573/,REF7696050485282
XXXXXXXX9648,DEBIT,OTHERS,390.27,20664.53,2015-07-05T10:30:00-05:00,2015-07-05,gL7sbFSwK3cZb0nV,IPS/NAVYUG FUEL/201909221916/000000000286/G URGAON,REF7267847350088
XXXXXXXX9648,DEBIT,OTHERS,7000.0,13664.53,2015-08-05T10:30:00-05:00,2015-08-05,jaZ0Jf2eHAHYlv93,ATM/SPCND037/CASH WDL/22-09-19,REF7150371795007
XXXXXXXX9648,DEBIT,OTHERS,3135.89,10528.64,2015-08-05T10:30:00-05:00,2015-08-05,EGYvIBzxlCALAm2j,VIN/IRCTC /201909232225/926616241232/,REF5278893350954
XXXXXXXX9648,DEBIT,OTHERS,129.42,10399.22,2015-09-05T10:30:00-05:00,2015-09-05,gjaoCeUBvIvBcZc2,MABchgs-Jul19+GST,REF8910903868514
XXXXXXXX9648,DEBIT,OTHERS,206.07,10193.15,2015-09-05T10:30:00-05:00,2015-09-05,fO9dSxp5RSvllM1o,MABchgs-Aug19+GST,REF4038544467862
XXXXXXXX9648,DEBIT,OTHERS,8000.0,2193.15,2015-10-05T10:30:00-05:00,2015-10-05,trm4NwkwOgU1PM48,ATM/SPCND037/CASH WDL/25-09-19,REF1251506905726
XXXXXXXX9648,CREDIT,OTHERS,2.33,2195.48,2015-10-05T10:30:00-05:00,2015-10-05,VFH2XHyplirEEYlv,VISA REF KARMVEER FILLING STATI,REF7618904004856
XXXXXXXX9648,DEBIT,OTHERS,310.0,1885.48,2015-11-05T10:30:00-05:00,2015-11-05,Dbc9ma7WPw7tkAid,VPS/24 Seven Fi/201909260137/926820397454/Delhi Ncr,REF6879556462556
XXXXXXXX9648,CREDIT,OTHERS,20000.0,21885.48,2015-11-05T10:30:00-05:00,2015-11-05,HAsEYwid6QJks0VJ,UPI/926892869318/Bhie/nimishapraka @yb/HDFC BANK LT,REF8383307632023
XXXXXXXX9648,CREDIT,OTHERS,59.57,21945.05,2015-12-05T10:30:00-05:00,2015-12-05,EWG08RcRwBSkwkky,APBS/IOC Ref No3000032581/9240987671691,REF5585624938375
XXXXXXXX9648,DEBIT,OTHERS,10000.0,11945.05,2015-12-05T10:30:00-05:00,2015-12-05,Tg9Ase5gLWCOC3tJ,ATM/SPCNH097/CASH WDL/26-09-19,REF5468979215275
XXXXXXXX9648,DEBIT,OTHERS,17.7,11927.35,2016-01-05T10:30:00-05:00,2016-01-05,H0d9vtZJCVf0bHvd,SMSChgsJul19-Sep19+GST,REF9380050245256
XXXXXXXX9648,DEBIT,OTHERS,510.0,11417.35,2016-01-05T10:30:00-05:00,2016-01-05,0vDcPL96tB1JjG49,BIL/RCHG/001808231297/Airtel DTH/3018748260,REF0077549456387
XXXXXXXX9648,CREDIT,OTHERS,2.93,11420.28,2016-02-05T10:30:00-05:00,2016-02-05,MJqVU6piocv7OjTG,IPS REF DT 23 09 2019 003493 HPCL 0 75 CASHLESS I,REF7237404874348
XXXXXXXX9648,DEBIT,OTHERS,5000.0,6420.28,2016-02-05T10:30:00-05:00,2016-02-05,yIE6SItVijLYyHCU,ATM/SPCND037/CASH WDL/28-09-19,REF2322813431653
XXXXXXXX9648,DEBIT,OTHERS,410.0,6010.28,2016-03-05T10:30:00-05:00,2016-03-05,gHnVM2jF0A1QrO8C,IPS/HP KATARIA /201909291454/000000002041/GURG AON,REF4699291225302
XXXXXXXX9648,DEBIT,OTHERS,696.0,5314.28,2016-03-05T10:30:00-05:00,2016-03-05,hjfGEV6HAf02zN0d,VPS/VGR SHOPPIN/201909292008/927214765635/GURGAON,REF5268951587737
XXXXXXXX9648,CREDIT,OTHERS,43.0,5357.28,2016-04-05T10:30:00-05:00,2016-04-05,ks1aOgHbygxmWTYF,083901503669:Int.Pd:29-06-2019 to 29-09-2019,REF0671177506389
XXXXXXXX9648,DEBIT,OTHERS,2000.0,3357.28,2016-04-05T10:30:00-05:00,2016-04-05,qurcRgQXGXXMnVmp,ATM/SPCND037/CASH WDL/01-10-19,REF3352082837463
XXXXXXXX9648,CREDIT,OTHERS,660.0,4017.28,2016-05-05T10:30:00-05:00,2016-05-05,livvfNkoxRFHEYCh,MMT/IMPS/927419773744/MOBLT0110190311/RAHUL KUM/S,REF2619611076271
XXXXXXXX9648,DEBIT,OTHERS,310.0,3707.28,2016-05-05T10:30:00-05:00,2016-05-05,pdZr3NKM3U98wVKr,VPS/BP 38 /201910031353/927608241579/GURG AON,REF4478702188322
XXXXXXXX9648,DEBIT,OTHERS,1000.0,2707.28,2016-06-05T10:30:00-05:00,2016-06-05,YhEtFaCciuuVFSLb,NFS/S1ANDE23/CASH WDL/04-10-19,REF2066010832542
XXXXXXXX9648,CREDIT,OTHERS,3.08,2710.36,2016-06-05T10:30:00-05:00,2016-06-05,pRp3wTAj4JVgBqM5,IPS REF DT 30 09 2019 011905 HPCL 0 75 CASHLESS I,REF7924865081687
XXXXXXXX9648,CREDIT,OTHERS,2320.0,5030.36,2016-07-05T10:30:00-05:00,2016-07-05,wO44pxo0W0ePqkAb,VISA REF IRCTC,REF6016459428327
XXXXXXXX9648,DEBIT,OTHERS,310.0,4720.36,2016-07-05T10:30:00-05:00,2016-07-05,QgRrIbPWcBOV2nNz,IPS/NAVYUG FUEL/201910061757/000000004681/G URGAON,REF7244407950736
XXXXXXXX9648,DEBIT,OTHERS,3000.0,1720.36,2016-08-05T10:30:00-05:00,2016-08-05,wyxLnqTCNax6OboR,ATM/SPCNH097/CASH WDL/07-10-19,REF4432481353545
XXXXXXXX9648,CREDIT,OTHERS,2.33,1722.69,2016-08-05T10:30:00-05:00,2016-08-05,yE8Qf9CpwsmIs9uh,VISA REF BP 38,REF8625860367271
XXXXXXXX9648,DEBIT,OTHERS,569.0,1153.69,2016-09-05T10:30:00-05:00,2016-09-05,tAVNUrLIDD39KAOi,BIL/RCHG/001819156092/Vodafone -/9711816337,REF7033453250072
XXXXXXXX9648,CREDIT,OTHERS,64.62,1218.31,2016-09-05T10:30:00-05:00,2016-09-05,TpRp44md7TnN8paA,APBS/IOC Ref No3000036126/9091094816026,REF6738332755671
XXXXXXXX9648,CREDIT,OTHERS,3000.0,4218.31,2016-10-05T10:30:00-05:00,2016-10-05,aXg5fDUyFiC7pPS7,UPI/928511794450/NO REMARKS/mryadav5008@upi/Allaha,REF0216761004227
XXXXXXXX9648,DEBIT,OTHERS,310.0,3908.31,2016-10-05T10:30:00-05:00,2016-10-05,MkTDMBocgRWsJRaX,IPS/MASTER FUEL/201910131237/000000000980/GURGAON,REF3473415568038
XXXXXXXX9648,DEBIT,OTHERS,3000.0,908.31,2016-11-05T10:30:00-05:00,2016-11-05,B1Yvp8csLHlF1r5R,NFS/S1ANMA96/CASH WDL/13-10-19,REF4317987177298
XXXXXXXX9648,CREDIT,OTHERS,64.62,972.93,2016-11-05T10:30:00-05:00,2016-11-05,Sy0jLb8Mx9tsCUJF,APBS/IOC Ref No3000037634/9111087652772,REF1861253103540
XXXXXXXX9648,DEBIT,OTHERS,26.0,946.93,2016-12-05T10:30:00-05:00,2016-12-05,dXyKWHnWFGdqjXZX,BIL/RCHG/001824020478/Vodafone -/9386178468,REF5869656119534
XXXXXXXX9648,DEBIT,OTHERS,310.0,636.93,2016-12-05T10:30:00-05:00,2016-12-05,kdSPdVuCUjRfeRY9,VPS/AKASHI FILL/201910160931/928904286115/GU RGAON,REF1359983056929
XXXXXXXX9648,CREDIT,OTHERS,10000.0,10636.93,2017-01-05T10:30:00-05:00,2017-01-05,Cuk94U3iLKT2Uici,INF/INFT/021616771861/AB ENTERPRISES /Manish,REF8961990462682
XXXXXXXX9648,DEBIT,OTHERS,10000.0,636.93,2017-01-05T10:30:00-05:00,2017-01-05,64mikiJJz0I2z665,NFS/S1ANND07/CASH WDL/17-10-19,REF8764877429586
XXXXXXXX9648,DEBIT,OTHERS,310.0,326.93,2017-02-05T10:30:00-05:00,2017-02-05,Q2o2uAnWq1AgzYBO,VPS/AKASHI FILL/201910191048/929205300775/GU RGAON,REF7737605317829
XXXXXXXX9648,DEBIT,OTHERS,326.92,0.01,2017-02-05T10:30:00-05:00,2017-02-05,IudpqhwDeV65BQB9,ECSRTNCHG211019_SR642420885,REF7397069716852
XXXXXXXX9648,CREDIT,OTHERS,2.33,2.34,2017-03-05T10:30:00-05:00,2017-03-05,OctGL0pPa13Qw2eQ,VISA REF AKASHI FILLING STATION,REF4971993856276
XXXXXXXX9648,CREDIT,OTHERS,2.33,4.67,2017-03-05T10:30:00-05:00,2017-03-05,iG96MzcrllMvtcCZ,VISA REF 24 Seven Filling Statio,REF7801121939521
XXXXXXXX9648,DEBIT,OTHERS,4.67,0.00,2017-04-05T10:30:00-05:00,2017-04-05,Af4FrfzKKtabG9Gv,ECSRTNCHG211019_SR642420885G ST,REF0455705100507
XXXXXXXX9648,CREDIT,OTHERS,2.33,2.33,2017-04-05T10:30:00-05:00,2017-04-05,p6sganF4WVx9L9xh,VPS REF AKASHI FILLING STATION,REF9958998497889
XXXXXXXX9648,CREDIT,OTHERS,10000.0,10002.33,2017-05-05T10:30:00-05:00,2017-05-05,Qvj1YNZevBrJgTNw,UPI/929842289858/Payment from Ph/7860890829@ybl/ID,REF0048095979585
XXXXXXXX9648,DEBIT,OTHERS,310.0,9692.33,2017-05-05T10:30:00-05:00,2017-05-05,LmXONt0vk6FU7WQD,VPS/KARMVEER FI/201910261051/929905741550/GUR GAON,REF8630419731223
XXXXXXXX9648,DEBIT,OTHERS,29.5,9662.83,2017-06-05T10:30:00-05:00,2017-06-05,U7PtWtsvjWlR9z2D,ATMDEC CHG/13-10-2019/1560+GST,REF0097139271016
XXXXXXXX9648,DEBIT,OTHERS,1000.0,8662.83,2017-06-05T10:30:00-05:00,2017-06-05,1gAKjchgYRQozreo,ATM/SPCND037/CASH WDL/27-10-19,REF9637050997820
XXXXXXXX9648,DEBIT,OTHERS,81.41,8581.42,2017-07-05T10:30:00-05:00,2017-07-05,FtIiNc2oEkicoZL3,ECSRTNCHG211019_SR642420885G ST,REF3842284604616
XXXXXXXX9648,DEBIT,OTHERS,4005.9,4575.52,2017-07-05T10:30:00-05:00,2017-07-05,rxQ0Lt4ctD0eMILr,MMT/IMPS/930410862353/Bick emi/Anand kuma/YESB0000,REF2479216839940
XXXXXXXX9648,CREDIT,OTHERS,2.33,4577.85,2017-08-05T10:30:00-05:00,2017-08-05,Dq6BgFseegS3MIGg,VISA REF KARMVEER FILLING STATI,REF5071646295159
XXXXXXXX9648,DEBIT,OTHERS,1529.0,3048.85,2017-08-05T10:30:00-05:00,2017-08-05,YtoOVuVNodcINAcL,CMS/000573987107/BAJAJ_AUTO_C D__580DPFFC021540,REF1356246511670
XXXXXXXX9648,CREDIT,OTHERS,1000.0,4048.85,2017-09-05T10:30:00-05:00,2017-09-05,rEtoLG3j7mv5Fokx,INF/INFT/021659577511/AB ENTERPRISES /Manish,REF9652717209442
XXXXXXXX9648,CREDIT,OTHERS,133.48,4182.33,2017-09-05T10:30:00-05:00,2017-09-05,EGqCWsknFqkq5ZCt,APBS/IOC Ref No3000041498/9061182243503,REF8690610772232
XXXXXXXX9648,CREDIT,OTHERS,48000.0,52182.33,2017-10-05T10:30:00-05:00,2017-10-05,MjncTTtdlQ1K6Vgo,BY CASH-GURGAON - PALAM VIHAR,REF8322529186816
XXXXXXXX9648,DEBIT,OTHERS,2705.9,49476.43,2017-10-05T10:30:00-05:00,2017-10-05,jotOFFt8nhxM6ZAw,MMT/IMPS/931418572327/NA/Ranjeet/ SBIN0006887,REF9898409546463
XXXXXXXX9648,DEBIT,OTHERS,10000.0,39476.43,2017-11-05T10:30:00-05:00,2017-11-05,blRbeU1nbrbej2mw,NFS/ID102001/CASH WDL/11-11-19,REF4065768518905
XXXXXXXX9648,CREDIT,OTHERS,7220.0,46696.43,2017-11-05T10:30:00-05:00,2017-11-05,Ae1sJsn2JE1bZs6H,ACH/AXAPK4225C-AY2019-20/CE19114741085,REF1080764399101
XXXXXXXX9648,DEBIT,OTHERS,30000.0,16696.43,2017-12-05T10:30:00-05:00,2017-12-05,f9fKJmJpnV43rowp,VPS/MEDICA HOSP/201911150354/931822500854/P ATNA,REF9664739338097
XXXXXXXX9648,DEBIT,OTHERS,2093.0,14603.43,2017-12-05T10:30:00-05:00,2017-12-05,3gaxdO79uJZxhnip,VPS/MEDICA HOSP/201911151350/931908523588/P ATNA,REF5537161654927
XXXXXXXX9648,DEBIT,OTHERS,909.0,13694.43,2018-01-05T10:30:00-05:00,2018-01-05,jCq5XYKf9mIhHoHs,VPS/MEDICA HOSP/201911152101/931915553298/P ATNA,REF8658037392954
XXXXXXXX9648,DEBIT,OTHERS,4408.0,9286.43,2018-01-05T10:30:00-05:00,2018-01-05,2SW45RdDg1RaQ2HJ,VPS/MEDICA HOSP/201911161512/932009561129/P ATNA,REF5498014804068
XXXXXXXX9648,DEBIT,OTHERS,304.0,8982.43,2018-02-05T10:30:00-05:00,2018-02-05,Qv3zjqQCpinviEOX,VPS/MEDICA HOSP/201911161823/932012592149/P ATNA,REF6538990559904
XXXXXXXX9648,DEBIT,OTHERS,1694.0,7288.43,2018-02-05T10:30:00-05:00,2018-02-05,MkXuFbCCwT93i5Ta,VPS/MEDICA HOSP/201911171501/932109543862/P ATNA,REF1811281706614
XXXXXXXX9648,DEBIT,OTHERS,5005.9,2282.53,2018-03-05T10:30:00-05:00,2018-03-05,f3QTLwKEMJ5nFAOW,MMT/IMPS/932315847916/Work dharmender/Dgarmender/A,REF1161334954804
XXXXXXXX9648,DEBIT,OTHERS,26.0,2256.53,2018-03-05T10:30:00-05:00,2018-03-05,R2jsxsRITUG3QvFh,BIL/RCHG/001851139780/Vodafone -/9386178468,REF5693131306669
XXXXXXXX9648,DEBIT,OTHERS,9.0,2247.53,2018-04-05T10:30:00-05:00,2018-04-05,CerOySvGsi7uo1P7,BIL/RCHG/001851140933/Vodafone -/9386178468,REF8596670327672
XXXXXXXX9648,CREDIT,OTHERS,5000.0,7247.53,2018-04-05T10:30:00-05:00,2018-04-05,LkYam8jrDKpM89f2,MMT/IMPS/932417412656/MB: MANISH/SONAL SRI/KOTAK,REF7553427557628
XXXXXXXX9648,DEBIT,OTHERS,3573.0,3674.53,2018-05-05T10:30:00-05:00,2018-05-05,OrCESGsOh3UAI2G2,ACH/INDUSIND BANK CFD/222681817,REF2898747644605
XXXXXXXX9648,DEBIT,OTHERS,399.0,3275.53,2018-05-05T10:30:00-05:00,2018-05-05,Mykr2ymxVPBgx4Dw,BIL/RCHG/001854170790/Airtel -D/9821315054,REF5172659159139
XXXXXXXX9648,DEBIT,OTHERS,2016.0,1259.53,2018-06-05T10:30:00-05:00,2018-06-05,0Laq3Sgx9csIijZ1,VPS/PUNJABI DHA/201911242152/932816519351/G URGAON,REF1292057176879
XXXXXXXX9648,DEBIT,OTHERS,208.43,1051.10,2018-06-05T10:30:00-05:00,2018-06-05,DiFlmUvkzWxCBwnr,IPS/AUTO CARE C/201911260943/000000011826/GUR GAON,REF1795874245356
XXXXXXXX9648,CREDIT,OTHERS,1000.0,2051.10,2018-07-05T10:30:00-05:00,2018-07-05,kk0uJqsuNCen9zlv,CLG/SONAL SRIVASTAVA/559754/SBI/24.10.2019,REF2966311889256
XXXXXXXX9648,DEBIT,OTHERS,1005.9,1045.20,2018-07-05T10:30:00-05:00,2018-07-05,RCBW7Y1z2OyAxvmd,MMT/IMPS/933108845703/Work/Dilip/I BKL0001836,REF5092041655660
XXXXXXXX9648,CREDIT,OTHERS,40000.0,41045.20,2018-08-05T10:30:00-05:00,2018-08-05,btR6fALQDeXm9KRO,BY CASH-GURGAON - NEW RAILWAY ROAD,REF5984919522589
XXXXXXXX9648,DEBIT,OTHERS,307.68,40737.52,2018-08-05T10:30:00-05:00,2018-08-05,aD2iB2dXVKvyH6Pe,IPS/AUTO CARE C/201911301240/000000012981/GUR GAON,REF6586568194828
XXXXXXXX9648,CREDIT,OTHERS,2500.0,43237.52,2018-09-05T10:30:00-05:00,2018-09-05,XCzqOBUBNpqBegLc,INF/INFT/021745787661/AB ENTERPRISES,REF4917365807776
XXXXXXXX9648,DEBIT,OTHERS,2858.49,40379.03,2018-09-05T10:30:00-05:00,2018-09-05,S4NHwsijkXXnjg1Q,VPS/SPENCERS /201911302057/933415464611/GURG AON,REF2276276987085
XXXXXXXX9648,DEBIT,OTHERS,1499.0,38880.03,2018-10-05T10:30:00-05:00,2018-10-05,iUQH9pjhU3VHriQQ,CMS/000585251940/BAJAJ_AUTO_C D__580DPFFC021540,REF7800651818383
XXXXXXXX9648,DEBIT,OTHERS,10005.9,28874.13,2018-10-05T10:30:00-05:00,2018-10-05,NuTIgCXNFfbpABAP,MMT/IMPS/933618405655/Work/Dgar mender/ALLA0212572,REF8454507254190
XXXXXXXX9648,DEBIT,OTHERS,1060.0,27814.13,2018-11-05T10:30:00-05:00,2018-11-05,PKoChE9b1D5E91Qq,VPS/YAJ FILLING/201912071739/934112141838 /GURGAON,REF4681815303308
XXXXXXXX9648,DEBIT,OTHERS,210.0,27604.13,2018-11-05T10:30:00-05:00,2018-11-05,DGYl6F5vclq77riu,VPS/BP 38 /201912081205/934206647426/GURG AON,REF4914593779778
XXXXXXXX9648,CREDIT,OTHERS,142.33,27746.46,2018-12-05T10:30:00-05:00,2018-12-05,D8RykwqIszmkOWPE,APBS/IOC Ref No3000048335/9061287849832,REF0941035698848
XXXXXXXX9648,DEBIT,OTHERS,3291.0,24455.46,2018-12-05T10:30:00-05:00,2018-12-05,En5Gtd6VLmimZgB0,LTGURXX42921 DEC19 Manish Kum,REF4741187110703
XXXXXXXX9648,DEBIT,OTHERS,4005.9,20449.56,2019-01-05T10:30:00-05:00,2019-01-05,RUSnuur1IWjdruOb,MMT/IMPS/934422411982/NA/Dgarme nder/ALLA0212572,REF4733610361503
XXXXXXXX9648,CREDIT,OTHERS,7.95,20457.51,2019-01-05T10:30:00-05:00,2019-01-05,XOax6f9IiZ6KyE1K,VPS REF YAJ FILLING STATION,REF1837025854267
XXXXXXXX9648,DEBIT,OTHERS,310.0,20147.51,2019-02-05T10:30:00-05:00,2019-02-05,6YhAGA9rTIHC9816,VPS/KARMVEER FI/201912121032/934605347308/GUR GAON,REF5781876122133
XXXXXXXX9648,CREDIT,OTHERS,1.58,20149.09,2019-02-05T10:30:00-05:00,2019-02-05,8jH32eqq7i1WtiTu,VISA REF BP 38,REF4383436228932
XXXXXXXX9648,DEBIT,OTHERS,445.0,19704.09,2019-03-05T10:30:00-05:00,2019-03-05,Ok9d8kU8WH5LMyR8,BIL/RCHG/001870900963/Airtel DTH/3018748260,REF4986951882645
XXXXXXXX9648,DEBIT,OTHERS,505.9,19198.19,2019-03-05T10:30:00-05:00,2019-03-05,kqe2PIg28rIKboGE,MMT/IMPS/934718295769/Adv/Sanjay ram/UTIB0001600,REF6569227708231
XXXXXXXX9648,DEBIT,OTHERS,410.0,18788.19,2019-04-05T10:30:00-05:00,2019-04-05,sqCC3lzfO6oONhed,VPS/AKASHI FILL/201912141838/934813141600/GU RGAON,REF6115212741053
XXXXXXXX9648,DEBIT,OTHERS,1005.9,17782.29,2019-04-05T10:30:00-05:00,2019-04-05,TwoV18yAjf2fFYMp,MMT/IMPS/934819737033/Work adv/Sanjay ram/UTIB0001,REF1022317970607
XXXXXXXX9648,DEBIT,OTHERS,2005.9,15776.39,2019-05-05T10:30:00-05:00,2019-05-05,Z528A3Ncb7YArK3u,MMT/IMPS/934918705416/NA/Sanjay ram/UTIB0001600,REF0419903207645
XXXXXXXX9648,DEBIT,OTHERS,1402.5,14373.89,2019-05-05T10:30:00-05:00,2019-05-05,rwx0MkUUEfwEkxSm,VPS/EASY DAY /201912152017/934914599409/GURG AON,REF0411880634995
XXXXXXXX9648,DEBIT,OTHERS,280.0,14093.89,2019-06-05T10:30:00-05:00,2019-06-05,8cPeWS8QWIJ2shuA,VPS/MSW MOOL CH/201912160152/934920001005/Delh i NC,REF0501950095939
XXXXXXXX9648,CREDIT,OTHERS,2.33,14096.22,2019-06-05T10:30:00-05:00,2019-06-05,iGg5AyJX7y0eBFaF,VPS REF KARMVEER FILLING STATI,REF9647777366107
XXXXXXXX9648,DEBIT,OTHERS,310.0,13786.22,2019-07-05T10:30:00-05:00,2019-07-05,j53OsCxMozODR7yJ,VPS/KARMVEER FI/201912181133/935206637963/GUR GAON,REF2982054717762
XXXXXXXX9648,CREDIT,OTHERS,3.08,13789.30,2019-07-05T10:30:00-05:00,2019-07-05,CzCsnJBvesfYmeZ0,VPS REF AKASHI FILLING STATION,REF7836433117525
XXXXXXXX9648,DEBIT,OTHERS,2005.9,11783.40,2019-08-05T10:30:00-05:00,2019-08-05,cDlLdnxxt36NbVA1,MMT/IMPS/935321399032/NA/Sanjay ram/UTIB0001600,REF6567062116296
XXXXXXXX9648,DEBIT,OTHERS,310.0,11473.40,2019-08-05T10:30:00-05:00,2019-08-05,M11yjrBiZuldnePB,VPS/KARMVEER FI/201912201056/935405926355/GUR GAON,REF9610623682564
XXXXXXXX9648,DEBIT,OTHERS,3573.0,7900.40,2019-09-05T10:30:00-05:00,2019-09-05,WuCeDrUuccAf2V6U,ACH/INDUSIND BANK CFD/222681818,REF6082680659675
XXXXXXXX9648,DEBIT,OTHERS,310.0,7590.40,2019-09-05T10:30:00-05:00,2019-09-05,V1RmJo5jxmTkKHcT,VPS/KARMVEER FI/201912221210/935606506101/GUR GAON,REF1210580126486
XXXXXXXX9648,DEBIT,OTHERS,2005.9,5584.50,2019-10-05T10:30:00-05:00,2019-10-05,O6MPN7KtaWXgTuA3,MMT/IMPS/935617475709/Work pay/Sanjay ram/UTIB0001,REF6549611265830
XXXXXXXX9648,DEBIT,OTHERS,17.7,5566.80,2019-10-05T10:30:00-05:00,2019-10-05,Q8CnUsa7ftyOSyTu,SMSChgsOct19-Dec19+GST,REF9350916611796
XXXXXXXX9648,CREDIT,OTHERS,2.33,5569.13,2019-11-05T10:30:00-05:00,2019-11-05,tNx6USVQNNeE0aC0,VPS REF KARMVEER FILLING STATI,REF7092432881198
XXXXXXXX9648,DEBIT,OTHERS,2005.9,3563.23,2019-11-05T10:30:00-05:00,2019-11-05,if8aTXYrC7OshJFe,MMT/IMPS/935813754295/NA/Dilip/IB KL0001836,REF9317213232850
XXXXXXXX9648,CREDIT,OTHERS,2.33,3565.56,2019-12-05T10:30:00-05:00,2019-12-05,7yCiKxJj9yGSCZJ2,VPS REF KARMVEER FILLING STATI,REF7632462775060
XXXXXXXX9648,DEBIT,OTHERS,310.0,3255.56,2019-12-05T10:30:00-05:00,2019-12-05,nXCMKpSa1D64cmif,VPS/KARMVEER FI/201912241835/935813411075/GUR GAON,REF1672292256131
XXXXXXXX9648,DEBIT,OTHERS,1005.9,2249.66,2020-01-05T10:30:00-05:00,2020-01-05,t6bpdsDSOjl5GsfX,MMT/IMPS/935818592955/NA/Sanjay ram/UTIB0001600,REF2995004754772
XXXXXXXX9648,DEBIT,OTHERS,188.0,2061.66,2020-01-05T10:30:00-05:00,2020-01-05,3AH8YYLVuRnNn3Pw,VPS/PVR LIMITED/201912251802/935912179207/GURGAON,REF7264826817995
XXXXXXXX9648,DEBIT,OTHERS,188.0,1873.66,2020-02-05T10:30:00-05:00,2020-02-05,s6rpiW4W49hmzPuo,VPS/PVR LIMITED/201912251807/935912185340/GURGAON,REF1087528236726
XXXXXXXX9648,DEBIT,OTHERS,593.0,1280.66,2020-02-05T10:30:00-05:00,2020-02-05,u3FnjBv3HgWBMdKj,VPS/PVR LIMITED/201912251818/935912199467/GURGAON,REF0983116340476
XXXXXXXX9648,CREDIT,OTHERS,50000.0,51280.66,2020-03-05T10:30:00-05:00,2020-03-05,gJnhggy580HF4HuG,MMT/IMPS/936108754313/MB: MANISH/SONAL SRI/KOTAK,REF0242401752669
XXXXXXXX9648,DEBIT,OTHERS,50005.9,1274.76,2020-03-05T10:30:00-05:00,2020-03-05,E7Ot23kMIPCvIKaQ,MMT/IMPS/936109403273/NA/AJIT KUMAR/SBIN0007234,REF4123965313709
XXXXXXXX9648,CREDIT,OTHERS,2.33,1277.09,2020-04-05T10:30:00-05:00,2020-04-05,cHINzcxfaGfiXb57,VPS REF KARMVEER FILLING STATI,REF1343833274354
XXXXXXXX9648,DEBIT,OTHERS,505.9,771.19,2020-04-05T10:30:00-05:00,2020-04-05,es6xrCE3v3TFgHDy,MMT/IMPS/936223557346/Work/Sanja y ram/UTIB0001600,REF7143621830139
XXXXXXXX9648,DEBIT,OTHERS,505.9,265.29,2020-05-05T10:30:00-05:00,2020-05-05,dXaaQOQOtOYwOpFp,MMT/IMPS/936320312987/NA/Sanjay ram/UTIB0001600,REF1283974938545
XXXXXXXX9648,CREDIT,OTHERS,10000.0,10265.29,2020-05-05T10:30:00-05:00,2020-05-05,HnjwVKNay5yGOHIY,MMT/IMPS/936323057770/MB: TRF/SONA ENTER/KOTAK MAH,REF5494318585028
XXXXXXXX9648,DEBIT,OTHERS,1005.9,9259.39,2020-06-05T10:30:00-05:00,2020-06-05,X4NpX4PnzLr0aNPj,MMT/IMPS/936323532014/Work/Sanja y ram/UTIB0001600,REF4923719377140
XXXXXXXX9648,CREDIT,OTHERS,142.33,9401.72,2020-06-05T10:30:00-05:00,2020-06-05,pzf43BD95SXwnA0W,APBS/IOC Ref No3000055111/9122822336835,REF4991145393494
XXXXXXXX9648,CREDIT,OTHERS,2.33,9404.05,2020-07-05T10:30:00-05:00,2020-07-05,CDyHjQWTWi0cLOkC,VPS REF KARMVEER FILLING STATI,REF4607539861990
XXXXXXXX9648,CREDIT,OTHERS,10000.0,19404.05,2020-07-05T10:30:00-05:00,2020-07-05,mgFwx3kxwcWgsaPW,UPI/936417326311/Maa ko diye ho/nimishapraka@yb/HD,REF2822792897128
XXXXXXXX9648,CREDIT,OTHERS,106.0,19510.05,2020-08-05T10:30:00-05:00,2020-08-05,kDX5gtC4YrEFUIfx,083901503669:Int.Pd:30-09-2019 to 30-12-2019,REF3832075516753
XXXXXXXX9648,DEBIT,OTHERS,1005.9,18504.15,2020-08-05T10:30:00-05:00,2020-08-05,K9pUvIbGSEI7FpqN,MMT/IMPS/936518176657/NA/Sanjay ram/UTIB0001600,REF6236279795465
XXXXXXXX9648,DEBIT,OTHERS,1005.9,17498.25,2020-09-05T10:30:00-05:00,2020-09-05,MB9BO7YUGKx4DtOt,MMT/IMPS/936520417401/NA/Sanjay ram/UTIB0001600,REF6947800878710
XXXXXXXX9648,CREDIT,OTHERS,1005.9,18504.15,2020-09-05T10:30:00-05:00,2020-09-05,SLo5vrdv2TCLh9cn,MMT/IMPS/936520417401/NA/Sanjay ram/UTIB0001600,REF6180180459427
XXXXXXXX9648,DEBIT,OTHERS,1005.9,17498.25,2020-10-05T10:30:00-05:00,2020-10-05,ki3qspy8IJ0yu0qC,MMT/IMPS/936520417793/NA/Sanjay ram/UTIB0001600,REF4896708721042
XXXXXXXX9648,CREDIT,OTHERS,1005.9,18504.15,2020-10-05T10:30:00-05:00,2020-10-05,YE3s8ArsgOq4z5PF,MMT/IMPS/936520417793/NA/Sanjay ram/UTIB0001600,REF7555880809410
XXXXXXXX9648,DEBIT,OTHERS,1005.9,17498.25,2020-11-05T10:30:00-05:00,2020-11-05,GYLUUCP7Veq4w2VF,MMT/IMPS/936522757422/NA/Sanjay ram/UTIB0001600,REF0835505909856
XXXXXXXX9648,CREDIT,OTHERS,1005.9,18504.15,2020-11-05T10:30:00-05:00,2020-11-05,U7I4P6J0LU1RTTIf,MMT/IMPS/936522757422/NA/Sanjay ram/UTIB0001600,REF3070174024540
XXXXXXXX9648,DEBIT,OTHERS,1499.0,17005.15,2020-12-05T10:30:00-05:00,2020-12-05,w8ez9yTfL4LlcMkw,CMS/000596441525/BAJAJ_AUTO_C D__580DPFFC021540,REF7505362896263
XXXXXXXX9648,DEBIT,OTHERS,599.0,16406.15,2020-12-05T10:30:00-05:00,2020-12-05,M5NdBEs5hNyJUAYl,BIL/RCHG/001884271432/Vodafone -/9711816337,REF2257535696522
XXXXXXXX9648,DEBIT,OTHERS,1005.9,15400.25,2021-01-05T10:30:00-05:00,2021-01-05,yeoH1AkFSW8pENvO,MMT/IMPS/000113427071/NA/Sanjay ram/UTIB0001600,REF9109406988119
XXXXXXXX9648,DEBIT,OTHERS,310.0,15090.25,2021-01-05T10:30:00-05:00,2021-01-05,mJUMWlu3sRikr0Hn,VPS/KARMVEER FI/202001021118/000205107464/GUR GAON,REF6051401438945
XXXXXXXX9648,DEBIT,OTHERS,10000.0,5090.25,2021-02-05T10:30:00-05:00,2021-02-05,GZ1RRgfjBhI8qyko,NFS/MC003187/CASH WDL/03-01-20,REF4086270751196
XXXXXXXX9648,DEBIT,OTHERS,310.0,4780.25,2021-02-05T10:30:00-05:00,2021-02-05,hGDIHIHaGsKziBVW,VPS/KARMVEER FI/202001040952/000404437668/GUR GAON,REF9669954498515
XXXXXXXX9648,DEBIT,OTHERS,307.68,4472.57,2021-03-05T10:30:00-05:00,2021-03-05,d8Cr7eR7HXz0jPgX,VPS/HPCL AUTO C/202001071032/000705174687/GUR GAON,REF2692759669072
XXXXXXXX9648,CREDIT,OTHERS,2.33,4474.90,2021-03-05T10:30:00-05:00,2021-03-05,fpil0e2rQDFK10P6,VPS REF KARMVEER FILLING STATI,REF9257566111240
XXXXXXXX9648,CREDIT,OTHERS,2000.0,6474.90,2021-04-05T10:30:00-05:00,2021-04-05,BLxYdkoc3K0jE6ww,INF/INFT/021870107051/Manish /AB ENTERPRIS,REF7525902190345
XXXXXXXX9648,CREDIT,OTHERS,2.33,6477.23,2021-04-05T10:30:00-05:00,2021-04-05,13x5zAVzahqaGhRq,VISA REF KARMVEER FILLING STATI,REF8691614640462
XXXXXXXX9648,DEBIT,OTHERS,310.0,6167.23,2021-05-05T10:30:00-05:00,2021-05-05,LyU80PFtvvWKE21h,VPS/FUEL JUNCTI/202001091511/000909386920 /GURGAON,REF8685318689147
XXXXXXXX9648,DEBIT,OTHERS,3291.0,2876.23,2021-05-05T10:30:00-05:00,2021-05-05,umynCOsEkxOzo07U,LTGURXX42921 JAN20 Manish Kum,REF2175525421978
XXXXXXXX9648,DEBIT,OTHERS,310.0,2566.23,2021-06-05T10:30:00-05:00,2021-06-05,LcUf9pR0Ur0JvqiT,IPS/RAJAN AUTO /202001111654/000000000032/GURG AON,REF7372128182514
XXXXXXXX9648,DEBIT,OTHERS,505.9,2060.33,2021-06-05T10:30:00-05:00,2021-06-05,hCdFwyapt6ypb8ts,MMT/IMPS/001221881253/NA/Sanjay akh/SBIN0003370,REF9589739340957
XXXXXXXX9648,CREDIT,OTHERS,2.32,2062.65,2021-07-05T10:30:00-05:00,2021-07-05,Yo1IbfHi9yrwfjck,IPS REF DT 12 01 2020 009901 HPCL 0 75 CASHLESS I,REF9449198125944
XXXXXXXX9648,CREDIT,OTHERS,10000.0,12062.65,2021-07-05T10:30:00-05:00,2021-07-05,FDVKue11FkkfNChW,UPI/001357175946/For mom/nimishapraka@yb/HDFC BANK,REF9491020682234
XXXXXXXX9648,DEBIT,OTHERS,6005.9,6056.75,2021-08-05T10:30:00-05:00,2021-08-05,LsfOE6rIqg4MDzjO,MMT/IMPS/001410582801/NA/Dgarme nder/ALLA0212572,REF3891624260805
XXXXXXXX9648,CREDIT,OTHERS,2.33,6059.08,2021-08-05T10:30:00-05:00,2021-08-05,1fToSLKq1VrEnnAw,VPS REF FUEL JUNCTION,REF1137045109616
XXXXXXXX9648,DEBIT,OTHERS,360.0,5699.08,2021-09-05T10:30:00-05:00,2021-09-05,YFg4dgMo3GE3OZ8M,BIL/RCHG/001896499353/Airtel DTH/3018748260,REF6613661675707
XXXXXXXX9648,DEBIT,OTHERS,2005.9,3693.18,2021-09-05T10:30:00-05:00,2021-09-05,nO4eeBmojwNPYc5V,MMT/IMPS/001620616474/NA/Sanjay ram/UTIB0001600,REF6776655714961
XXXXXXXX9648,DEBIT,OTHERS,379.0,3314.18,2021-10-05T10:30:00-05:00,2021-10-05,ZRMuPwLBrnlRm1KS,BIL/RCHG/001898568724/Vodafone -/8877377811,REF4240588955661
XXXXXXXX9648,CREDIT,OTHERS,10000.0,13314.18,2021-10-05T10:30:00-05:00,2021-10-05,UokKzY66fQYGlcJi,MMT/IMPS/002020901951/MB: MANISH/SONAL SRI/KOTAK,REF4786968198773
XXXXXXXX9648,DEBIT,OTHERS,3573.0,9741.18,2021-11-05T10:30:00-05:00,2021-11-05,GSfQZusT8D0KPcZf,ACH/INDUSIND BANK CFD/222681819,REF1254621292092
XXXXXXXX9648,DEBIT,OTHERS,2005.9,7735.28,2021-11-05T10:30:00-05:00,2021-11-05,2FywnuKEefCinIpL,MMT/IMPS/002118889372/NA/Sanjay ram/UTIB0001600,REF1948972819021
XXXXXXXX9648,CREDIT,OTHERS,500.0,8235.28,2021-12-05T10:30:00-05:00,2021-12-05,B2C3O0A1eYKYx29P,UPI/002122274691/Payment from Ph/nimishapraka@yb/H,REF0668488546681
XXXXXXXX9648,CREDIT,OTHERS,156.43,8391.71,2021-12-05T10:30:00-05:00,2021-12-05,ORNWk80EbjqsVzWa,APBS/IOC Ref No5040741606/0012173242045,REF7048549128917
XXXXXXXX9648,DEBIT,OTHERS,177.0,8214.71,2022-01-05T10:30:00-05:00,2022-01-05,zgeaGN4ZYnEycimJ,DCARDFEE1560DEC19-NOV20+GST,REF5488876686010
XXXXXXXX9648,DEBIT,OTHERS,1499.0,6715.71,2022-01-05T10:30:00-05:00,2022-01-05,GPDLJExOnnkSYuw1,CMS/000608498489/BAJAJ_AUTO_C D__580DPFFC021540,REF2388799834234
XXXXXXXX9648,DEBIT,OTHERS,307.68,6408.03,2022-02-05T10:30:00-05:00,2022-02-05,rG0q7yzEwsWhEgob,IPS/AUTO CARE C/202002071021/000000012447/GUR GAON,REF4454598839299
XXXXXXXX9648,DEBIT,OTHERS,3405.9,3002.13,2022-02-05T10:30:00-05:00,2022-02-05,JC2TGhuLOnDqOf2w,MMT/IMPS/003811225673/NA/Fire delhi/UBIN0553646,REF7576435328704
XXXXXXXX9648,CREDIT,OTHERS,10000.0,13002.13,2022-03-05T10:30:00-05:00,2022-03-05,Nkri0gnoKYTQ3qGk,UPI/003854373080/Patna rent/nimishapraka@yb/HDFC B,REF8556586064552
XXXXXXXX9648,DEBIT,OTHERS,2505.9,10496.23,2022-03-05T10:30:00-05:00,2022-03-05,PyvXJFDSWXiWlcHn,MMT/IMPS/003920777546/NA/Dgarme nder/ALLA0212572,REF6047820820183
XXXXXXXX9648,DEBIT,OTHERS,345.0,10151.23,2022-04-05T10:30:00-05:00,2022-04-05,xpH76u2KRZGDxIXe,BIL/RCHG/001917523519/Airtel DTH/3018748260,REF0379597021761
XXXXXXXX9648,DEBIT,OTHERS,3291.0,6860.23,2022-04-05T10:30:00-05:00,2022-04-05,GOY96Z6hSvu11YNp,LTGURXX42921 FEB20 Manish Kum,REF1713018870564
XXXXXXXX9648,DEBIT,OTHERS,37.0,6823.23,2022-05-05T10:30:00-05:00,2022-05-05,SVKfPuFCYSKuzVOc,BIL/RCHG/001918894484/Vodafone -/9386178468,REF5503750890795
XXXXXXXX9648,DEBIT,OTHERS,310.0,6513.23,2022-05-05T10:30:00-05:00,2022-05-05,CK1ENtsoeWfp9dXD,VPS/AKASHI FILL/202002110929/004203483745/GU RGAON,REF4262118252519
XXXXXXXX9648,DEBIT,OTHERS,1000.0,5513.23,2022-06-05T10:30:00-05:00,2022-06-05,0fbUbayGYmaXZ1JR,UPI/004312921077/Oid10325597416@ /add-money@paytm/P,REF1989584330995
XXXXXXXX9648,CREDIT,OTHERS,2.33,5515.56,2022-06-05T10:30:00-05:00,2022-06-05,nNqXeMm3Wu6LcIzO,VPS REF AKASHI FILLING STATION,REF6980525062993
XXXXXXXX9648,DEBIT,OTHERS,38.0,5477.56,2022-07-05T10:30:00-05:00,2022-07-05,5oOsoWxG56xGGZQW,UPI/004993334660/NA/8083684960@o kbi/Axis Bank Ltd.,REF2429969204176
XXXXXXXX9648,CREDIT,OTHERS,10000.0,15477.56,2022-07-05T10:30:00-05:00,2022-07-05,REvI3GIjnZIAxznh,MMT/IMPS/005017363126/MB: MANISH/SONAL SRI/KOTAK,REF6416404597521
XXXXXXXX9648,DEBIT,OTHERS,5005.9,10471.66,2022-08-05T10:30:00-05:00,2022-08-05,KNfGGFauype4rsdw,MMT/IMPS/005017562939/NA/Dgarme nder/ALLA0212572,REF1581557688919
XXXXXXXX9648,DEBIT,OTHERS,3573.0,6898.66,2022-08-05T10:30:00-05:00,2022-08-05,YKHBEmkE6KgEMxPX,ACH/INDUSIND BANK CFD/222681820,REF0193291409582
XXXXXXXX9648,CREDIT,OTHERS,500.0,7398.66,2022-09-05T10:30:00-05:00,2022-09-05,jaeCbtTLz0smOjoS,UPI/005311116043/Payment from Ph/nimishapraka@yb/H,REF3164369607803
XXXXXXXX9648,CREDIT,OTHERS,50.0,7448.66,2022-09-05T10:30:00-05:00,2022-09-05,LQMdcPmOmU1soUWE,UPI/005349052582/Promo Cashback/upi-cashback@pa/Pa,REF6007217857847
XXXXXXXX9648,DEBIT,OTHERS,3005.9,4442.76,2022-10-05T10:30:00-05:00,2022-10-05,ImmY8xAoPLe0DAL0,MMT/IMPS/005410398109/NA/Dgarme nder/ALLA0212572,REF4167309144786
XXXXXXXX9648,DEBIT,OTHERS,60.0,4382.76,2022-10-05T10:30:00-05:00,2022-10-05,MNVVipjXbc4RyPXy,UPI/005578318380/NA/Q94808044@y bl/Canara Bank,REF3213204311717
XXXXXXXX9648,DEBIT,OTHERS,400.82,3981.94,2022-11-05T10:30:00-05:00,2022-11-05,PgPuImQFoHDAVGOF,VPS/FUEL JUNCTI/202002261204/005706293163 /GURGAON,REF9180457182465
XXXXXXXX9648,DEBIT,OTHERS,555.0,3426.94,2022-11-05T10:30:00-05:00,2022-11-05,8ZDx3if69TvfRnGt,UPI/005814342987/Amount to pay/jio@citibank/Citiba,REF0018644307602
XXXXXXXX9648,CREDIT,OTHERS,290.05,3716.99,2022-12-05T10:30:00-05:00,2022-12-05,7tqYG2oukRb7WbBi,APBS/IOC Ref No5240203446/0022775580200,REF1063369929521
XXXXXXXX9648,CREDIT,OTHERS,3.01,3720.00,2022-12-05T10:30:00-05:00,2022-12-05,aUhQBblIYTlNTRI1,VISA REF FUEL JUNCTION,REF3023655513870
XXXXXXXX9648,DEBIT,OTHERS,1499.0,2221.00,2023-01-05T10:30:00-05:00,2023-01-05,20CDk34n12glpidf,CMS/000621014112/BAJAJ_AUTO_C D__580DPFFC021540,REF2085318167487
XXXXXXXX9648,CREDIT,OTHERS,10000.0,12221.00,2023-01-05T10:30:00-05:00,2023-01-05,e52IziwMDciZ30pX,MMT/IMPS/006308613327/MB: TRF/SONA ENTER/KOTAK MAH,REF8122937333250
XXXXXXXX9648,DEBIT,OTHERS,6005.9,6215.10,2023-02-05T10:30:00-05:00,2023-02-05,l81DhlG3rDs9b05Y,MMT/IMPS/006318893424/Work/Dgar mender/ALLA0212572,REF2448880097262
XXXXXXXX9648,DEBIT,OTHERS,5005.9,1209.20,2023-02-05T10:30:00-05:00,2023-02-05,BuxEEI0oSrDmNpgu,MMT/IMPS/006319069936/NA/Manu hdfc/HDFC0004233,REF4054281978199
XXXXXXXX9648,CREDIT,OTHERS,40000.0,41209.20,2023-03-05T10:30:00-05:00,2023-03-05,H2xPRFXFNCFOf5Zf,BY CASH-GURGAON - SECTOR-4,REF0548607950735
XXXXXXXX9648,DEBIT,OTHERS,320.0,40889.20,2023-03-05T10:30:00-05:00,2023-03-05,N9fPmisiaK7tBqCM,VPS/PETRO FUELS/202003061154/006606698283/ GURGAON,REF8321571744875
XXXXXXXX9648,DEBIT,OTHERS,17.7,40871.50,2023-04-05T10:30:00-05:00,2023-04-05,qyIO6bRd9QlIFvVy,SMSChgsJan20-Mar20+GST,REF0391676547372
XXXXXXXX9648,DEBIT,OTHERS,2505.9,38365.60,2023-04-05T10:30:00-05:00,2023-04-05,4QTmmRTObhBJKunw,MMT/IMPS/006717587879/Plot no 32r/Dgarmender/ALLA0,REF6059785366972
XXXXXXXX9648,DEBIT,OTHERS,580.0,37785.60,2023-05-05T10:30:00-05:00,2023-05-05,r8kUOtUglrX9WZs3,UPI/006859519458/Oid202003082137/ paytm-10577598@/P,REF9969836121088
XXXXXXXX9648,DEBIT,OTHERS,3291.0,34494.60,2023-05-05T10:30:00-05:00,2023-05-05,QUBpta9WU6b6GsGf,LTGURXX42921 MAR20 Manish Kum,REF6107451161079
XXXXXXXX9648,CREDIT,OTHERS,870.0,35364.60,2023-06-05T10:30:00-05:00,2023-06-05,SmBEzg7qwl4x1Chz,BIL/INFT/001943690479/NA/,REF6323976767630
XXXXXXXX9648,CREDIT,OTHERS,2.4,35367.00,2023-06-05T10:30:00-05:00,2023-06-05,XR22AGue0FAH8n5I,VPS REF PETRO FUELS,REF2281826907128
XXXXXXXX9648,DEBIT,OTHERS,30.0,35337.00,2023-07-05T10:30:00-05:00,2023-07-05,pMLhBnvu7CTJ5WNx,UPI/007195164096/Oid202003111906/ paytm-50063499@/P,REF2898505437494
XXXXXXXX9648,DEBIT,OTHERS,469.35,34867.65,2023-07-05T10:30:00-05:00,2023-07-05,IYMglOR2HRYLEXXV,VPS/SEC IV GURG/202003162124/007615551467/ GURGAON,REF2447746292411
XXXXXXXX9648,DEBIT,OTHERS,156.45,34711.20,2023-08-05T10:30:00-05:00,2023-08-05,lzbKXL2l3Guc0ovU,VPS/SEC IV GURG/202003162140/007616562604/ GURGAON,REF0275403732509
XXXXXXXX9648,DEBIT,OTHERS,81.9,34629.30,2023-08-05T10:30:00-05:00,2023-08-05,rFK9ni2Yqfwv2GXX,VPS/SEC IV GURG/202003162153/007616570226/ GURGAON,REF6895204969989
XXXXXXXX9648,CREDIT,OTHERS,229.57,34858.87,2023-09-05T10:30:00-05:00,2023-09-05,nk9QaHgwl7GUBHYf,APBS/IOC Ref No5267238540/0031675861635,REF5528655440616
XXXXXXXX9648,DEBIT,OTHERS,351.0,34507.87,2023-09-05T10:30:00-05:00,2023-09-05,sxV7OToU1GVOO1cy,UPI/008004095684/Oid10578557640@ /paydth5848@payt/P,REF0402693491190
XXXXXXXX9648,DEBIT,OTHERS,219.0,34288.87,2023-09-05T10:30:00-05:00,2023-09-05,2MZq9EKGYfOsDt7n,UPI/008007370914/Oid10580205536@ /payair7673@payt/P,REF9729765590661
XXXXXXXX9648,DEBIT,OTHERS,3573.0,30715.87,2023-09-05T10:30:00-05:00,2023-09-05,9IGo2nPXijqPAaTc,ACH/INDUSIND BANK CFD/222681804,REF8711924413821
XXXXXXXX9648,DEBIT,OTHERS,5005.9,25709.97,2023-09-05T10:30:00-05:00,2023-09-05,hfT21xg3agESFvGH,MMT/IMPS/008116323425/NA/Dgarme nder/ALLA0212572,REF9938126877292
XXXXXXXX9648,DEBIT,OTHERS,2005.9,23704.07,2023-09-05T10:30:00-05:00,2023-09-05,upCZhLdFbrcgEter,MMT/IMPS/008421032744/Rm/Dgarme nder/ALLA0212572,REF3720335102505
XXXXXXXX9648,DEBIT,OTHERS,3500.0,20204.07,2023-09-05T10:30:00-05:00,2023-09-05,ThdtjvB7l75TwFMb,BIL/INFT/001954208405/Only trf/,REF2025541319811
XXXXXXXX9648,CREDIT,OTHERS,113.0,20317.07,2023-09-05T10:30:00-05:00,2023-09-05,7qxgcvgl6TEfYupw,083901503669:Int.Pd:31-12-2019 to 29-03-2020,REF7848180396125
XXXXXXXX9648,DEBIT,OTHERS,1499.0,18818.07,2023-09-05T10:30:00-05:00,2023-09-05,3t1VvRGZfymBYBZu,CMS/000632000467/BAJAJ_AUTO_C D__580DPFFC021540,REF5774426326828
XXXXXXXX9648,DEBIT,OTHERS,199.0,18619.07,2023-09-05T10:30:00-05:00,2023-09-05,WCgjBak4sKxrEFlU,UPI/009416611053/Oid10674349538@ /paybil3066@payt/P,REF8803974594867
XXXXXXXX9648,DEBIT,OTHERS,1887.0,16732.07,2023-09-05T10:30:00-05:00,2023-09-05,Z311e0IsBmEKrMc8,UPI/009525804812/Oid10682326500@ /paytm-ptmgtp@pa/P,REF4890305314449
XXXXXXXX9648,DEBIT,OTHERS,5005.9,11726.17,2023-09-05T10:30:00-05:00,2023-09-05,XfE6DHSCrwOmaSR6,MMT/IMPS/009712811213/NA/K mama/PUNB0093200,REF9019567718198
XXXXXXXX9648,DEBIT,OTHERS,2000.0,9726.17,2023-09-05T10:30:00-05:00,2023-09-05,lkmDWdT9ebBZMhhR,BIL/INFT/001962736128/Rambhu lal/,REF5039399930409
XXXXXXXX9648,CREDIT,OTHERS,161.48,9887.65,2023-09-05T10:30:00-05:00,2023-09-05,KW3LNnRYL2Ytgwst,APBS/IOC Ref No5326869887/0040866807409,REF7187321189121
XXXXXXXX9648,DEBIT,OTHERS,599.0,9288.65,2023-09-05T10:30:00-05:00,2023-09-05,rE2IVru3jBrETUTZ,UPI/010170551635/Vodafone Prepai/vilprepaidbr@hs/H,REF7635163493388
XXXXXXXX9648,DEBIT,OTHERS,20.0,9268.65,2023-09-05T10:30:00-05:00,2023-09-05,nrP8IdMn1LdhZiYV,UPI/010170603405/Vodafone Prepai/vilprepaidbr@hs/H,REF7348312578629
XXXXXXXX9648,DEBIT,OTHERS,2505.9,6762.75,2023-09-05T10:30:00-05:00,2023-09-05,vTZtJdUcBCsHpw2I,MMT/IMPS/010320437500/NA/Sukla/K ARB0000261,REF8071033380475
XXXXXXXX9648,DEBIT,OTHERS,219.0,6543.75,2023-09-05T10:30:00-05:00,2023-09-05,05koKaFFm5vBdYrc,UPI/010823898902/Oid10765283343@ /payair7673@payt/P,REF2471579163418
XXXXXXXX9648,CREDIT,OTHERS,818.0,7361.75,2023-09-05T10:30:00-05:00,2023-09-05,sbJME7mRK2EqBuLD,BIL/INFT/001972297642/Cylinder Refill/,REF8386338353022
XXXXXXXX9648,DEBIT,OTHERS,2000.0,5361.75,2023-09-05T10:30:00-05:00,2023-09-05,YQSi2swLJRhtqgrC,BIL/INFT/001973663047/Rambhu/,REF4854960817154
XXXXXXXX9648,CREDIT,OTHERS,161.48,5523.23,2023-09-05T10:30:00-05:00,2023-09-05,DNVhA8qPdirENFVt,APBS/IOC Ref No5372010721/0042733548560,REF3352629276483
XXXXXXXX9648,DEBIT,OTHERS,10.0,5513.23,2023-09-05T10:30:00-05:00,2023-09-05,9zGaCqGrCad7fzYG,UPI/012131129144/NA/9953331462@p ayt/Punjab Nationa,REF1580416925211
XXXXXXXX9648,DEBIT,OTHERS,450.0,5063.23,2023-09-05T10:30:00-05:00,2023-09-05,xPKlqQcRsHfLgZmY,UPI/012138188018/Payment from Ph/7860890829@ybl/ID,REF4106137556774
XXXXXXXX9648,DEBIT,OTHERS,1499.0,3564.23,2023-09-05T10:30:00-05:00,2023-09-05,OCUQaPJtIccM70eS,CMS/000639325220/BAJAJ_AUTO_C D__580DPFFC021540,REF0011740989680
XXXXXXXX9648,CREDIT,OTHERS,2000.0,5564.23,2023-09-05T10:30:00-05:00,2023-09-05,ukdZVm3UoRBilCYs,UPI/012338088746/Payment from Ph/7860890829@ybl/ID,REF3714607705066
XXXXXXXX9648,DEBIT,OTHERS,5.0,5559.23,2023-09-05T10:30:00-05:00,2023-09-05,RZX9ZCdCAUzVGMTM,UPI/012644197426/Payment from Ph/9821315054@ybl/Or,REF4628630459189
XXXXXXXX9648,CREDIT,OTHERS,150.0,5709.23,2023-09-05T10:30:00-05:00,2023-09-05,URk8UIphmxmx8KuQ,UPI/012776674520/ALL202005062168/ payouts@paytm/Pay,REF9370798559131
XXXXXXXX9648,DEBIT,OTHERS,500.0,5209.23,2023-09-05T10:30:00-05:00,2023-09-05,ai6Crfg8I14fC3Uu,UPI/013010283319/Oid10903499630@ /add-money@paytm/P,REF5926118541213
XXXXXXXX9648,DEBIT,OTHERS,500.0,4709.23,2023-09-05T10:30:00-05:00,2023-09-05,rGKjEAzYCeMVSiu5,BIL/INFT/001984045576/NA/,REF9811898731180
XXXXXXXX9648,DEBIT,OTHERS,250.0,4459.23,2023-09-05T10:30:00-05:00,2023-09-05,BCzezieNwRK7ohrh,UPI/013663222328/Payment from Ph/7860890829@ybl/ID,REF9985017283785
XXXXXXXX9648,CREDIT,OTHERS,3000.0,7459.23,2023-09-05T10:30:00-05:00,2023-09-05,bers5hyP8acZ9896,MMT/IMPS/013916443063/trensfer/RA MAN KUMA/Indian B,REF1498928931100
XXXXXXXX9648,DEBIT,OTHERS,1500.0,5959.23,2023-09-05T10:30:00-05:00,2023-09-05,RqN5nsUAUNtsFq3F,UPI/014120252597/Fee for feb mar/31934296858SBIN/S,REF0997314347189
XXXXXXXX9648,DEBIT,OTHERS,395.9,5563.33,2023-09-05T10:30:00-05:00,2023-09-05,3vdwhB8lr1fxbohq,VPS/KARMVEER FI/202005271904/014813357795/GUR GAON,REF0596649624447
XXXXXXXX9648,DEBIT,OTHERS,300.0,5263.33,2023-09-05T10:30:00-05:00,2023-09-05,wDPojl2mK4qkw7bs,BIL/INFT/001997087681/Key b/,REF6898868591885
XXXXXXXX9648,DEBIT,OTHERS,1800.0,3463.33,2023-09-05T10:30:00-05:00,2023-09-05,A59cAoRoJ4rAFuVF,UPI/015360836446/Payment from Ph/9868412784@ybl/St,REF5191956463785
XXXXXXXX9648,CREDIT,OTHERS,2.97,3466.30,2023-09-05T10:30:00-05:00,2023-09-05,qgjbFcQ50NUF4ENX,VPS REF KARMVEER FILLING STATI,REF2787576624465
XXXXXXXX9648,DEBIT,OTHERS,3291.0,175.30,2023-09-05T10:30:00-05:00,2023-09-05,6zlXYRCHJUD9mpnK,LTGURXX42921 JUN20 Manish Kum,REF3774892521361
XXXXXXXX9648,DEBIT,OTHERS,17.7,157.60,2023-09-05T10:30:00-05:00,2023-09-05,KpixxDwu8h4DlqBE,SMSChgsApr20-Jun20+GST,REF5244266871902
XXXXXXXX9648,DEBIT,OTHERS,29.5,128.10,2023-09-05T10:30:00-05:00,2023-09-05,fkn25L6EuYuyZi5w,POSDEC CHG/13-06-2020/1560+GST,REF8023845141657
XXXXXXXX9648,DEBIT,OTHERS,29.5,98.60,2023-09-05T10:30:00-05:00,2023-09-05,lXvG4cPL4wJp7v6n,POSDEC CHG/13-06-2020/1560+GST,REF7420032599160
XXXXXXXX9648,CREDIT,OTHERS,20000.0,20098.60,2023-09-05T10:30:00-05:00,2023-09-05,Hqo3tFb6n5jGQyCB,MMT/IMPS/017909681551/MB Sent to MAN /SONAL SRI/K,REF2474270516183
XXXXXXXX9648,DEBIT,OTHERS,496.48,19602.12,2023-09-05T10:30:00-05:00,2023-09-05,52KC6r2OgVMwcIVA,IPS/NAVYUG FUEL/202006271305/000000002550/G URGAON,REF7256827622764
XXXXXXXX9648,CREDIT,OTHERS,50.0,19652.12,2023-09-05T10:30:00-05:00,2023-09-05,BjaoIKQh67E9tFfU,083901503669:Int.Pd:30-03-2020 to 28-06-2020,REF0626134106974
XXXXXXXX9648,DEBIT,OTHERS,7920.0,11732.12,2023-09-05T10:30:00-05:00,2023-09-05,OeAhqFHk48vfu0ti,UPI/018191842787/Oid11223273131@ /paytm-ptmbbp@pa/P,REF4006949281418
XXXXXXXX9648,DEBIT,OTHERS,10005.9,1726.22,2023-09-05T10:30:00-05:00,2023-09-05,rXvbWCmJyGnTqcUL,MMT/IMPS/018701339104/Ma/Manu hdfc/HDFC0004233,REF9527540042728
XXXXXXXX9648,CREDIT,OTHERS,10000.0,11726.22,2023-09-05T10:30:00-05:00,2023-09-05,HoAJc53WItCEWDw6,MMT/IMPS/019009556269/MB: MK/SONAL SRI/Kotak Mahi,REF0744631297422
XXXXXXXX9648,DEBIT,OTHERS,3291.0,8435.22,2023-09-05T10:30:00-05:00,2023-09-05,1qsI6h26IKTEnzRZ,LTGURXX42921 JUL20 Manish Kum,REF1734556544329
XXXXXXXX9648,DEBIT,OTHERS,2005.9,6429.32,2023-09-05T10:30:00-05:00,2023-09-05,GQ3U6TZ80hDXf27E,MMT/IMPS/019209063872/Work/Prince kum/UBIN0537853,REF1462396322766
XXXXXXXX9648,DEBIT,OTHERS,247.08,6182.24,2023-09-05T10:30:00-05:00,2023-09-05,xtgwFAP5VoYzT7wV,UPI/019548213358/Oid11323813126@ /paydth5848@payt/P,REF7884196424395
XXXXXXXX9648,DEBIT,OTHERS,1000.0,5182.24,2023-09-05T10:30:00-05:00,2023-09-05,dAqzuTzO8PEksEiq,BIL/INFT/002029411390/Mobile sell/,REF6713500806224
XXXXXXXX9648,DEBIT,OTHERS,806.22,4376.02,2023-09-05T10:30:00-05:00,2023-09-05,ZiXeRCYujge2ybuP,IPS/AUTO CARE C/202007151323/000000001932/GUR GAON,REF3708391354529
XXXXXXXX9648,DEBIT,OTHERS,3573.0,803.02,2023-09-05T10:30:00-05:00,2023-09-05,vBUYj3S90jdyvE0R,ACH/INDUSIND BANK CFD/222681808,REF6059619246450
XXXXXXXX9648,CREDIT,OTHERS,10000.0,10803.02,2023-09-05T10:30:00-05:00,2023-09-05,rkvBQpga5NpEEVfN,UPI/021164921292/Payment from Ph/ukumari12@ybl/Sta,REF2094537257656
XXXXXXXX9648,DEBIT,OTHERS,500.0,10303.02,2023-09-05T10:30:00-05:00,2023-09-05,Ib4ombPxR0B9wrZT,UPI/021242599955/NA/9910866074@p ayt/Paytm Payments,REF5243198318686
XXXXXXXX9648,DEBIT,OTHERS,149.0,10154.02,2023-09-05T10:30:00-05:00,2023-09-05,0YgH2bLiW3DXcOIK,UPI/021349096665/Oid11414428293@ /payvod0796@payt/P,REF0224055534428
XXXXXXXX9648,DEBIT,OTHERS,250.0,9904.02,2023-09-05T10:30:00-05:00,2023-09-05,ePLhGcaFdZl1fymg,UPI/021353583390/Oid11408271097@ /paydth5848@payt/P,REF9188183801292
